...--.O.
.V.--...
...-....
...-....
E---....
........
